EEFEEEEEFFEEEEEEEEEE
FESFESFEFSEHFESFESFE
SESFHSFEFSESFESFESEE
EESFESFEEEESFESHEESE
EESFEEFEFSESFESESESE
EESFESFEFSESFESESESE
EEFFESFEFSESFESESEEE
EESFESFEFSEEEEEESFEE
EEEEESHEFSESFESFESEE
EESFESFEEEESFESEESEE
EESFEEEEFSESFEEEESEE
EFSFESFEFSESFESEEEEE
EESFESFEHSEEFESFESEE
EEEEESEEFSESFESFEFEE
EESFESFEFSESFEESESEE
EEEFEEEEEEEFFEEEEEEE