EESFSSEEEEEEEEEEEEEE
FEEEEEEEFSESSESFESFE
FSEFESFEFSESFESFESEE
FSEFESFEEEESFESHEESE
FFEFFEFEHSESFESESESE
EEESHSFEFSESFHSESESE
SEEEESFESFESFFSESFEE
FEEFSSFEFSEEEEEESFEE
EEESFSSEFSESFESEESEE
SEEFESFEEEESFESFEEHF
SFEEEEEEFSESFEEEESFE
EFSFESSEFSESFESFEFES
EHSFESFEFSEEFEEEESEF
ESFEESEESFESEESFEEEE
EEEEESFEFSEEESFSESFE
SSEFEEEEEEEFEEAFESFE