EEEEEEEEFFEEEEEEEEEE
ESSFESFEFSEHFESFESFE
SFEEESFEFSESFESFHSEE
EESFESFSSFDEEEEEFFEE
EESFEHFEFSEFSSEEEEEE
EESFESFEFSESFEEFSESE
SFEEESFEFSESFFEFSFEE
FHSFESFEFSEEEEEEFEEE
FEEEESFESSESFSEFSFHS
SESFESFEEEESFEEFEFSF
EESFEEEEFSESFEESESFS
EFSEFSFEFSESFSEEEEEE
EESFESFEFSEHSFEFFSFE
EEEEESEEFSESSEESEEEE
EFFSESFEFSESFEEFEFSE
EEHFEEEEEEEEFEEEEEEE