EEEEEEEEEEEEEEEEEEEE
EFSFEFHEFSEHFESFESEE
EFSFESFEFSESFESFESEE
EESFESFEEEESFESFEESE
FESFHEFEFSESFESESESE
FESFESFEFSESFESEHESE
EEEFFSFEFSESFESESFEE
EESFFSFEFSEEEEFESFEE
EEEEESFEFSESFESEESES
EESFESFEFSESFESFESEF
EESFEEEEFSESFESFESEF
EESFFSFEFSESFESFEEEE
EESFESFEFSEHFESFESEE
EEEEESEEFSESFESFESEE
EESFESFEFSESFEEEESEE
EEEEEEEEEEEEEEEEEEEE