EFEFSSEESEEFFEEEEEEE
EFEEEEEEFSEHFESFESFE
ESHFESFEESESFESFESEE
EFSFESFEEEEEEESHEESE
EEEEEEFEHSFSSFSSFESE
ESFSFSFEFSEEEHSEEEEE
EEEFeSSESFESFFSESFEE
SEEFESFEFSEEEEEESFEF
ESEEEEEEFSESFESEESES
EEEFESFEEEESFESFEFEE
FSFSEEEEFSFSFEEEESFH
HFSEESSEFHEEFESFEFES
EEEEFSFEFSEEFEEEESEF
SESFEEEESFESEESFEEEE
FEESEFSFESEFESFSFSES
SEFSEHEEEFEEEFEEEEEE