EESFHEEEEFEEEEFFEFHE
ESSFSFEFESESFEEEESFE
EFEEEEEFFFEFFESFEEEE
EEEFESEEEEESFESHEESE
FSSEESESFSEESFSSFSEE
FHFESEESHFSEFSEESESE
SESESEFSEEFESHSESSSE
FEEEFEFFFEEEFEFSEEEE
EFSSFEESESESFESFESEF
SSSESESHSEESFESEESSS
FHSFEEEEFSEEEEFSEEEH
SEFEESFEFSEEFEFEESSF
EESFEEFESFESFSFSEEFS
EEEEEEEFFSFSHFSSEEFE
FESFFFFSSSFSFEFSEEEF
EEEHFSEEEEEFFSEEEFEE