EEEEEEEEEEEEEEEEEEEE
EESFEEHEFSEHFESFESEE
EESFESFEFSESFESFESEE
EESFESFEEEESFESFEESE
EESFHEFEFSESFESESESE
EESFESFEFSESFESESESE
EEEFESFEFSESFESESFEE
EESFESFEFSEEEEFESFEE
EEHEESFEFSESFESFESEE
EESFESFEFSESFESFESEE
EESFEEEEFSESFESFESEE
EESFESFEFSESFESFEEEE
EESFESFEFSEHFESFESEE
EEEEESEEFSESFESFESEE
EESFESFEFSESFEEEESEE
EEEEEEEEEEEEEEEEEEEE